....#....
...###...
..#####..
.#######.
..#####..
...###...
....#....