#########
.#######.
..#####..
...###...
....#....