....#....
.#######.
.#######.
#..###..#
.#.###.#.
....#....